00000000000000000000000000000000000000000000000000
00220000000000000000000000000000000000000000002200
22112200000000000000000000000000000000000000221122
11111100000000000000000000000000000000000000111111
11111100000000000000000000000000000000000000111111
11111100000000000000000000000000000000000000111111
11111100000000000000000000000000000000000000111111
11111100000000000000000000000000000000000000111111
11111100000000000000000000000000000000000000111111
11111100000000000000000000000000000000000000111111
11111100000000000000000000000000000000000000111111
11111100000000000000000000000000000000000000111111
11111100000000000000000000000000000000000000111111
11111100000000000022222000000222220000000000111111
11111100000000000000000000000000000000000000111111
11111100000000000000000000000000000000000000111111
11111100000000000000000022222200000000000000111111
11111100000002222000000000000000000222222000111111
11111100000000000000000000000000000000000000111111
11111100000000022000000000000000000000222000111111
11111100000000000000000000000000000000000000111111
11111100000000000000000000000000000000000000111111
11111100000002222000000000000000000222222000111111
11111100000000000000000000000000000000000000111111
11111100000000000022222000000222220000000000111111
11111102222000000000000000000000000000000000111111
11111100000000000000000000000000000000000000111111
11111100000002222000000000000000000222222000111111
11111100000000000000000022222200000000000000111111
11111100000000000000000000000000000000000000111111
11111100000000000000000000000000000000000000111111
11111122222222222222222222222222222222222222111111
11111111111111111111111111111111111111111111111111
11111111111111111111111111111111111111111111111111
11111111111111111111111111111111111111111111111111
11111111111111111111111111111111111111111111111111
11111111111111111111111111111111111111111111111111
11111111111111111111111111111111111111111111111111
00000000000000000000000000000000000000000000000000
00000000000000000000000000000000000000000000000000
00000000000000000000000000000000000000000000000000
00000000000000000000000000000000000000000000000000
00000000000000000000000000000000000000000000000000
00000000000000000000000000000000000000000000000000
00000000000000000000000000000000000000000000000000
00000000000000000000000000000000000000000000000000
